**S**********************************************************
      *        *G             *                       *     *
****  *  *  *  *************  ****  *  ****  *******  *  *  *
*        *  *  *              *     *     *        *     *  *
*  *************  **********  ****  *******  ****  *******  *
*     *  *     *  *        *  *  *     *        *        *  *
*  ****  *  *  *  *  *  *  ****  ****  ****  ****  ****  ****
*           *  *     *  *  *     *  *  *     *        *     *
*  **********  *  *  *  ****  *  *  *  *  ****  *******  *  *
*  *  *  *        *  *        *  *     *  *     *     *  *  *
*  *  *  *******  *  *  *  *************************  ****  *
*  *     *        *  *  *           *  *                    *
*  ****  ****************  *  *******  ****  *  ****  *  *  *
*           *        *     *  *     *  *     *  *     *  *  *
*  ****  ****  *  **********  *  ****  *  ****  *  *  *******
*  *  *  *     *  *     *  *              *  *  *  *  *     *
*  *  *******  ****  *  *  *******  *******  *  *******  *  *
*     *        *  *  *     *     *        *     *  *     *  *
*  ****  *******  ****  *  ****  ****  ****  ****  ****  ****
*     *     *  *  *     *     *           *     *     *  *  *
*  ****  ****  *  *  *  ****  *  *  **********  *  ****  *  *
*  *  *  *     *  *  *     *     *        *           *     *
*  *  *  *  ****  *  ****  *  *  ****  *  *  ****  *  *  ****
*  *  *  *  *     *     *  *  *  *  *  *  *  *  *  *     *  *
*  *  *  *  ****  *******  *  *  *  *  *  ****  *  *  *  *  *