************
*          *
* ******** *
*    *   * *
*** **** * *
*S     *G  *
************
